4

15 20 0
====================
=    =     X  ^ !*@=
=X   =  T       !**=
=    =     *    !#!=
===**=             =
=             F    =
=  !        E    * =
=       ^          =
======#=    !      =
=      =           =
=      =X          =
=      =    *    M =
= K    =           =
=     X=W     ^ E  =
====================