15 20 105
====================
=    !      *   F  =
= T  !  ^   * W  X =
=    X      *      =
=!!!!!      ***=====
=              =!!!=
=        I     *!**=
=              #!*@=
= X  !         *!**=
=          M   =!!!=
======         =====
=D   !    *        =
=  K # ^      X  E =
=    =      F      =
====================